You went on a fishing trip with a friend off the Malé Sea Port in the Maldive Islands. You don't remember much from what had happened but you recall the waves being really rough since there was a huge hurricane approaching that you were unaware of. You also remember crying and panicing because your friend had fell off the boat and was sucked into the deep sea in no time. You must've passed out or something becasue you don't remmeber the rest. Luckily, you wake up on this seem-to-be abandoned island. I mean the Maldive Islands are composed with over 1,200 islands…You must be on one of those?

Stranded
An Interactive Fiction by Kaitlyn Poentis
Release 1 / Serial number 140219 / Inform 7 build 6G60 (I6/v6.32 lib 6/12N) SD

Beach
You wake up on warm sand in pain. You must've been rolling in the reef when you got tossled around by the waves. Your face, as well as the rest of your body seems to have multiple cuts.

You can see an Ocean, a palm trees and a piece of the wood here.

>x cuts
You can't see any such thing.

* * *

>x players face
You can't see any such thing.

* * *

>x ocean
The ocean that took your friend, your ship, and almost your life. It is also known as the Arabian Sea.