You went on a fishing trip with a friend off the Malé Sea Port in the Maldive Islands. You don't remember much from what had happened but you recall the waves being really rough since there was a huge hurricane approaching that you were unaware of. You also remember crying and panicing because your friend had fell off the boat and was sucked into the deep sea in no time. You must've passed out or something becasue you don't remmeber the rest. Luckily, you wake up on this seem-to-be abandoned island. I mean the Maldive Islands are composed with over 1,200 islands…You must be on one of those?

Stranded
An Interactive Fiction by Kaitlyn Poentis
Release 1 / Serial number 140221 / Inform 7 build 6G60 (I6/v6.32 lib 6/12N) SD

Beach
You wake up on warm sand in pain. You must've been rolling in the reef when you got tossled around by the waves. Your face, as well as the rest of your body seems to have multiple cuts.

You can see an ocean, some palm trees and a piece of wood here.

>x players face
You can't see any such thing.

>x face
You can't see any such thing.

>x body
You can't see any such thing.

* * *

>x palm trees
Many tall palm trees line up in rows basically creating a wall of trunks.

>e
Wooden Structure
You enter a wooden structure. I dont really know what it is, but it is definitely not trees or anything natural. There seems to be beams, along with what looks like a house foundation. It is about 3 feet set up above the ground.

You can see some dirty clothes here.

* * *

>x ocean
The ocean that took your friend, your ship, and almost your life. It is also known as the Arabian Sea.

>go in ocean
It's kinda cold, I'm also a little scared to be in here, given the circumstances.

>exit ocean
I only understood you as far as wanting to exit.

>get out of ocean
I only understood you as far as wanting to get outside.

>leave ocean
I only understood you as far as wanting to leave.

>stand up
You get off the Ocean.

Beach
You wake up on warm sand in pain. You must've been rolling in the reef when you got tossled around by the waves. Your face, as well as the rest of your body seems to have multiple cuts.

You can see an Ocean here.

* * *

>e
You head east and stumble upon the many palm trees and run into a…
Wooden Structure
You enter a wooden structure. I dont really know what it is, but it is definitely not trees or anything natural. There seems to be beams, along with what looks like a house foundation. The platform is about 3 feet set up above the ground and there is a brass box in the corner.

You can see some dirty clothes here.

>e
Small forest
You enter a small area full of trees and shurbs. The sun shines through the leaves and trees so perfectly making this whole situation feel so fake. The ground is covered with rocks, moss and dead leaves.

You can see a branch and some bananas here.

>x bananas
The yellow or green bananas hang in bunches up in their trees. They look so delicious.

* * *

>e
You head east and stumble upon the many palm trees and run into a…
Wooden Structure
You enter a wooden structure. I dont really know what it is, but it is definitely not trees or anything natural. There seems to be beams, along with what looks like a house foundation. The platform is about 3 feet set up above the ground and there is a brass box in the corner.

You can see some dirty clothes here.

>x brass box
A 3x3 brass box is in the corner of the platform. Like the clothes, it is dusty and dirty.

* * *

>x cuts
You can't see any such thing.

>x face
You can't see any such thing.

>cuts
That's not a verb I recognise.