You went on a fishing trip with a friend off the Malé Sea Port in the Maldive Islands. You don't remember much from what had happened but you recall the waves being really rough since there was a huge hurricane approaching that you were unaware of. You also remember crying and panicing because your friend had fell off the boat and was sucked into the deep sea in no time. You must've passed out or something becasue you don't remmeber the rest. Luckily, you wake up on this seem-to-be abandoned island. I mean the Maldive Islands are composed with over 1,200 islands…You must be on one of those?

Stranded
An Interactive Fiction by Kaitlyn Poentis
Release 1 / Serial number 140311 / Inform 7 build 6G60 (I6/v6.32 lib 6/12N) SD

Beach
You wake up on warm sand in pain. You must've been rolling in the reef when you got tossled around by the waves. Your face, as well as the rest of your body seems to have multiple cuts. A large piece of wood, is only a few feet away from you. You must have been floated here on that. In the distance to the east, you can see a wooden structure.

You can see an ocean, some palm trees, a piece of wood and an east ocean here.

>x beach
You can't see any such thing.

>igui
That's not a verb I recognise.

>iuhh34e
That's not a verb I recognise.

>fuigus
That's not a verb I recognise.

>dfsdug
That's not a verb I recognise.

>heriughi
That's not a verb I recognise.

>dfhhg
That's not a verb I recognise.

>e
You head east and stumble upon the many palm trees and run into a…
Wooden Structure
You enter a wooden structure. I dont really know what it is, but it is definitely not trees or anything natural. There seems to be beams, along with what looks like a house foundation. The platform is about 3 feet set up above the ground and there is a brass box in the corner.

You can see some dirty clothes here.

>e
Small forest
You enter a small area full of trees and shurbs. The sun shines through the leaves and trees so perfectly making this whole situation feel so fake. The ground is covered with rocks, moss and dead leaves.

You can see a branch, some bananas and a thin plastic card here.

>e
You can't go that way.

>e
You can't go that way.

I beg your pardon?

>n
You can't go that way.

>w
Wooden Structure
You enter a wooden structure. I dont really know what it is, but it is definitely not trees or anything natural. There seems to be beams, along with what looks like a house foundation. The platform is about 3 feet set up above the ground and there is a brass box in the corner.

You can see some dirty clothes here.

I beg your pardon?

>s
You can't go that way.

>v
That's not a verb I recognise.

>r
That's not a verb I recognise.

>b
That's not a verb I recognise.

I beg your pardon?

>n
Boulders
An empty place free of many trees. Although there are lots of shurbs surrounding hte big rocky place.

You can see some shrubs and some berries here.

>n
Lagoon
The lagoon has a slight tint of turquoise and is insanely clear. The waterfall that feeds the lagoon is probably about 100 foot long from the top of the rocks down to the pool. To the south of you is the boulders and to the west is stream that leads to a tide pool and to the east is more trees and a pond?

You can see a Cave here.

>s
Boulders
An empty place free of many trees. Although there are lots of shurbs surrounding hte big rocky place.

You can see some shrubs and some berries here.

>r
That's not a verb I recognise.

>v
That's not a verb I recognise.

>w
You can't go that way.

>erg
That's not a verb I recognise.

>v
That's not a verb I recognise.

>d
You can't go that way.

>c
That's not a verb I recognise.

>e
Open field
You enter a serene open, grassy area. It is like an open field you'd see in movies with couples lying in the grass and picking the dandilions. To the east you see an open field and south of you is the wooden structure.

>g
Large forest
The thickness of all the trees surrounding the area makes it very dark and a little hard to see There is a lot of moister in the air making it very hot. To your west is an Open field and to your east looks like an opening out of the forest.

>h
That's not a verb I recognise.

>e
East Beach
The sand is a little finer and whiter than the beach you first woke up on. The waves are a lot more calm and don't freak me out as much either. To your west is the opening back into the Large forest.

>d
You can't go that way.

I'm really hungry and thirsty, I could really go for some food and something to drink right now.

>bd
That's not a verb I recognise.

>x
What do you want to examine?

>d
You see nothing unexpected in that direction.

>w
Large forest
The thickness of all the trees surrounding the area makes it very dark and a little hard to see There is a lot of moister in the air making it very hot. To your west is an Open field and to your east looks like an opening out of the forest.

>b
That's not a verb I recognise.

* * *

I beg your pardon?

>d
You can't go that way.

>d
You can't go that way.

>df
That's not a verb I recognise.

>f
That's not a verb I recognise.

I beg your pardon?

>b
That's not a verb I recognise.

* * *

I beg your pardon?

I beg your pardon?

>g
That's not a verb I recognise.

I beg your pardon?

* * *

>x ocean
The ocean that took your friend, your ship, and almost your life. It is also known as the Arabian Sea.

Dude, you are sooooo hungry.

>x wood
A very large piece of wood that you washed up onto shore on.

I'm weak, tired and especially starving!

>e
You head east and stumble upon the many palm trees and run into a…
Wooden Structure
You enter a wooden structure. I dont really know what it is, but it is definitely not trees or anything natural. There seems to be beams, along with what looks like a house foundation. The platform is about 3 feet set up above the ground and there is a brass box in the corner.

You can see some dirty clothes here.

I need food now… Please?lothes

>e
Small forest
You enter a small area full of trees and shurbs. The sun shines through the leaves and trees so perfectly making this whole situation feel so fake. The ground is covered with rocks, moss and dead leaves.

You can see some bananas, a branch and a thin plastic card here.

I'm weak, tired and especially starving!

* * *

>x ocean
The ocean that took your friend, your ship, and almost your life. It is also known as the Arabian Sea.

Dude, you are sooooo hungry.

>x palm tree
I only understood you as far as wanting to examine the palm trees.

>x wood
A very large piece of wood that you washed up onto shore on.

>take wood
The wood is too heavy for me to pick up, but I can drag it.

>n
You can't go that way.

>w
You can't go that way.

>e
You head east and stumble upon the many palm trees and run into a…
Wooden Structure
You enter a wooden structure. I dont really know what it is, but it is definitely not trees or anything natural. There seems to be beams, along with what looks like a house foundation. The platform is about 3 feet set up above the ground and there is a brass box in the corner.

You can see some dirty clothes here.

>s
You can't go that way.

>x clothes
A pile of old, dusty, dirty t-shirts and baggy pants.

>x box
A 3x3 ft brass box is in the corner of the platform. Like the clothes, it is dusty and dirty.

>open box
It seems to be locked.

>take box
That's hardly portable.

>use wood
You can't wear that!

>break box
Violence isn't the answer to this one.

* * *

>x piece of wood
A very large piece of wood that you washed up onto shore on.

I'm weak, tired and especially starving!

>take wood
The wood is too heavy for me to pick up, but I can drag it.

I need food.

>go on wood
You can't see any such thing.

>enter wood
You can only get into something free-standing.

I need food.

>enter the piece of wood
You can only get into something free-standing.

I can't function without my food!

>sit on the piece of wood
You can only get into something free-standing.

I need food.

* * *

>x piece of wood
A very large piece of wood that you washed up onto shore on.

I'm weak, tired and especially starving!

>x wood
You can't see any such thing.

* * *

>brake wood
You brake and hit the large piece of wood into many pieces. It now looks like fire wood?

I really could go for a burger and some ice cream.

>take wood
I've got it. This is much easier to carry than it's whole big piece.

It feels as though you haven't eaten in weeks. Months, almost.

>e
You head east and stumble upon the many palm trees and run into a…
Wooden Structure
You enter a wooden structure. I dont really know what it is, but it is definitely not trees or anything natural. There seems to be beams, along with what looks like a house foundation. The platform is about 3 feet set up above the ground and there is a brass box in the corner.

You can see some dirty clothes here.

My tummy is growling so loud.

>take dirty clothes
I guess I'll carry it…but it's filthy.

Food would be REALLY great right now.

>e
Small forest
You enter a small area full of trees and shurbs. The sun shines through the leaves and trees so perfectly making this whole situation feel so fake. The ground is covered with rocks, moss and dead leaves.

You can see some bananas, a branch and a thin plastic card here.

Dude, you are sooooo hungry.

>use branch and hit bananas
You can't use multiple objects with that verb.

>use branch
(first taking the branch)
I've got it!

You are holding the branch in your right hand like it is a violent obeject.

Some pizza would be awesome!

>hit bananas
You use the branch and hit the branches that are holding the bananas until a bunch of the bananas fall to the ground.

Some pizza would be awesome!

>x bananas
The yellow or green bananas hang in bunches up in their trees. They look so delicious.

Food would be REALLY great right now.

>eat bananas
(first taking the bananas)
OK got them.

You eat the bananas in happiness.

>w
Wooden Structure
You enter a wooden structure. I dont really know what it is, but it is definitely not trees or anything natural. There seems to be beams, along with what looks like a house foundation. The platform is about 3 feet set up above the ground and there is a brass box in the corner.

>n
Boulders
An empty place free of many trees. Although there are lots of shurbs surrounding hte big rocky place.

You can see some shrubs and some berries here.

>n
Lagoon
The lagoon has a slight tint of turquoise and is insanely clear. The waterfall that feeds the lagoon is probably about 100 foot long from the top of the rocks down to the pool. To the south of you is the boulders and to the west is stream that leads to a tide pool and to the east is more trees and a pond?

You can see a Cave and a jug here.

>w
Pond
More exotic plants cover the ground around the pond. The water must come from the Lagoon next door. But the water is filled with tons of algae, fish are capable of living here.

>x ground
You look at the ground and see thick green green grass. But you aslo see something shiny, metal colored almost fully covered by the grass. It looks like a key.

>x key
A weathered down brass key. The supposedly jagged edges of the key is smoothing out. The key must be pretty old.

>take key
Taken.

>s
You can't go that way.

>s
You can't go that way.

>e
Lagoon
The lagoon has a slight tint of turquoise and is insanely clear. The waterfall that feeds the lagoon is probably about 100 foot long from the top of the rocks down to the pool. To the south of you is the boulders and to the west is stream that leads to a tide pool and to the east is more trees and a pond?

You can see a Cave and a jug here.

>s
Boulders
An empty place free of many trees. Although there are lots of shurbs surrounding hte big rocky place.

You can see some shrubs and some berries here.

>s
Wooden Structure
You enter a wooden structure. I dont really know what it is, but it is definitely not trees or anything natural. There seems to be beams, along with what looks like a house foundation. The platform is about 3 feet set up above the ground and there is a brass box in the corner.

>x brass box
A 3x3 ft brass box is in the corner of the platform. Like the clothes, it is dusty and dirty.

>use key
You can't wear that!

>use key to open brass box
I only understood you as far as wanting to use the key.

>use key
You can't wear that!

>open brass box
It seems to be locked.

>use key
You can't wear that!

>unlock brass box
What do you want to unlock the brass box with?

>the key
You unlock the brass box.

>open the box
You open the brass box, revealing a journal.

>x journal
A really old, fragile journal that has tons of pages falling out as you pick it up. The writting from pen and pencil marks are barely visable or readable.

>take journal
Taken.

>n
Boulders
An empty place free of many trees. Although there are lots of shurbs surrounding hte big rocky place.

You can see some shrubs and some berries here.

* * *

>n
Lagoon
The lagoon has a slight tint of turquoise and is insanely clear. The waterfall that feeds the lagoon is probably about 100 foot long from the top of the rocks down to the pool. To the south of you is the boulders and to the west is stream that leads to a tide pool and to the east is more trees and a pond?

You can see a Cave and a jug here.

>e
North forest
Nothing more ordinary than just another forest here on this abandoned island; tons of trees, moss, shurbs, etc. There's a lot of mysterious noises it freaks me out. It almost sounds like machinery and a bunch of beeping. But I thought there was no one on this island?

You can see Melvin here.

>talk to melvin
"Hi, there," you say hesitantly.

"**jumps** Um hi…" he replies stunned.

>g
"Who are you? Are you stuck on this island too?"

"No definitely not, I came here in search of data or especially this book, or journal that carries A LOT of information."

Some pizza would be awesome!

>g
"Oh, do you know how you can get me off this island. I've been stuck for a while, I really need help. I need to get to Malé."

"Ummm I have lost all connections with going back to the city…Ahemm, I'm going to go about my day if thats okay."

My tummy is growling so loud.

>give journal to melvin
Melvin looks very pleased.

Dude, you are sooooo hungry.

>ask for magnifying glass
You can't see any such thing.

>ask for magnifying glass
You can't see any such thing.

>ask melivin for the magnifying glass
You can't see any such thing.

>ask melvin for magnifying glass
Now you have the magnifying glass.

I can't function without my food!

* * *

>x sand
You can't see any such thing.

>x reef
You can't see any such thing.

>x waves
You can't see any such thing.

>x face
You can't see any such thing.

>x self
As good-looking as ever.

>x cuts
You can't see any such thing.

>x ocean
The ocean that took your friend, your ship, and almost your life. It is also known as the Arabian Sea.

>x trees
Many tall palm trees line up in rows basically creating a wall of trunks.

>x wood
A very large piece of wood that you washed up onto shore on.

* * *

>take wood
The wood is too heavy for me to pick up, but I can drag it.

>enter ocean
It's kinda cold, I'm also a little scared to be in here, given the circumstances.

>e
(first getting off the ocean)

Wooden Structure
You enter a wooden structure. I dont really know what it is, but it is definitely not trees or anything natural. There seems to be beams, along with what looks like a house foundation. The platform is about 3 feet set up above the ground and there is a brass box in the corner.

You can see some dirty clothes here.

* * *

>e
You head east and stumble upon the many palm trees and run into a…
Wooden Structure
You enter a wooden structure. I dont really know what it is, but it is definitely not trees or anything natural. There seems to be beams, along with what looks like a house foundation. The platform is about 3 feet set up above the ground and there is a brass box in the corner.

You can see some dirty clothes here.

I can't function without my food!

>e
Small forest
You enter a small area full of trees and shurbs. The sun shines through the leaves and trees so perfectly making this whole situation feel so fake. The ground is covered with rocks, moss and dead leaves.

You can see some bananas, a branch and a thin plastic card here.

Some pizza would be awesome!

>x bananas
The yellow or green bananas hang in bunches up in their trees. They look so delicious.

>take bananas
They are too tall for me to reach or jump and reach to get them. You're not that tall.

>x branch
You see nothing special about the branch.

* * *

>e
Small forest
You enter a small area full of trees and shurbs. The sun shines through the leaves and trees so perfectly making this whole situation feel so fake. The ground is covered with rocks, moss and dead leaves.

You can see some bananas, a branch and a thin plastic card here.

Some pizza would be awesome!

>w
Wooden Structure
You enter a wooden structure. I dont really know what it is, but it is definitely not trees or anything natural. There seems to be beams, along with what looks like a house foundation. The platform is about 3 feet set up above the ground and there is a brass box in the corner.

You can see some dirty clothes here.

It feels as though you haven't eaten in weeks. Months, almost.

>n
Boulders
An empty place free of many trees. Although there are lots of shurbs surrounding hte big rocky place.

You can see some shrubs and some berries here.

I can't function without my food!

>n
Lagoon
The lagoon has a slight tint of turquoise and is insanely clear. The waterfall that feeds the lagoon is probably about 100 foot long from the top of the rocks down to the pool. To the south of you is the boulders and to the west is stream that leads to a tide pool and to the east is more trees and a pond?

You can see a Cave and a jug here.

I can't function without my food!

>e
North forest
Nothing more ordinary than just another forest here on this abandoned island; tons of trees, moss, shurbs, etc. There's a lot of mysterious noises it freaks me out. It almost sounds like machinery and a bunch of beeping. But I thought there was no one on this island?

You can see Melvin here.

I really could go for a burger and some ice cream.

>talk to melvine
You can't see any such thing.

>talk to melvin
"Hi, there," you say hesitantly.

"**jumps** Um hi…" he replies stunned.

Some pizza would be awesome!

>ask melvin for magnifying glass
Melvin has better things to do.

My tummy is growling so loud.

>give magnifying glass to player
You can't see any such thing.

* * *

>e
North forest
Nothing more ordinary than just another forest here on this abandoned island; tons of trees, moss, shurbs, etc. There's a lot of mysterious noises it freaks me out. It almost sounds like machinery and a bunch of beeping. But I thought there was no one on this island?

You can see Melvin here.

I really could go for a burger and some ice cream.

>talk to melvin
"Hi, there," you say hesitantly.

"**jumps** Um hi…" he replies stunned.

Dude, you are sooooo hungry.

* * *

>e
Small forest
You enter a small area full of trees and shurbs. The sun shines through the leaves and trees so perfectly making this whole situation feel so fake. The ground is covered with rocks, moss and dead leaves.

You can see some bananas, a branch and a thin plastic card here.

Some pizza would be awesome!

>take bananas
They are too tall for me to reach or jump and reach to get them. You're not that tall.

* * *

>e
Small forest
You enter a small area full of trees and shurbs. The sun shines through the leaves and trees so perfectly making this whole situation feel so fake. The ground is covered with rocks, moss and dead leaves.

You can see some bananas, a branch and a thin plastic card here.

Some pizza would be awesome!

>x ground
You can't see any such thing.

>take branch
I've got it!

I really could go for a burger.

>use branch
You are holding the branch in your right hand like it is a violent obeject.

I'm weak, tired and especially starving!

>hit bananas
You use the branch and hit the branches that are holding the bananas until a bunch of the bananas fall to the ground.

I need food now… Please?it the

>take bananas
OK got them.

I can't function without my food…!

>eat bananas
You eat the bananas in happiness.

>e
You can't go that way.

>w
Wooden Structure
You enter a wooden structure. I dont really know what it is, but it is definitely not trees or anything natural. There seems to be beams, along with what looks like a house foundation. The platform is about 3 feet set up above the ground and there is a brass box in the corner.

You can see some dirty clothes here.

* * *

>e
Small forest
You enter a small area full of trees and shurbs. The sun shines through the leaves and trees so perfectly making this whole situation feel so fake. The ground is covered with rocks, moss and dead leaves.

You can see some bananas, a branch and a thin plastic card here.

Some pizza would be awesome!

>use branch
(first taking the branch)
I've got it!

You are holding the branch in your right hand like it is a violent obeject.

>hit bananas
You use the branch and hit the branches that are holding the bananas until a bunch of the bananas fall to the ground.

>hit bananas
You use the branch and hit the branches that are holding the bananas until a bunch of the bananas fall to the ground.

>eat bananas
(first taking the bananas)
OK got them.

You eat the bananas in happiness.

* * *

>e
You head east and stumble upon the many palm trees and run into a…
Wooden Structure
You enter a wooden structure. I dont really know what it is, but it is definitely not trees or anything natural. There seems to be beams, along with what looks like a house foundation. The platform is about 3 feet set up above the ground and there is a brass box in the corner.

You can see some dirty clothes here.

I can't function without my food!

>x brass box
A 3x3 brass box is in the corner of the platform. Like the clothes, it is dusty and dirty.

>open box
It seems to be locked.

* * *

>e
You head east and stumble upon the many palm trees and run into a…
Wooden Structure
You enter a wooden structure. I dont really know what it is, but it is definitely not trees or anything natural. There seems to be beams, along with what looks like a house foundation. The platform is about 3 feet set up above the ground and there is a brass box in the corner.

You can see some dirty clothes here.

I can't function without my food!

>tkae clothes
That's not a verb I recognise.

>take clothes
I guess I'll carry it…but it's filthy.

Dude, you are sooooo hungry.

>n
Boulders
An empty place free of many trees. Although there are lots of shurbs surrounding hte big rocky place.

You can see some shrubs and some berries here.

I'm weak, tired and especially starving!

>n
Lagoon
The lagoon has a slight tint of turquoise and is insanely clear. The waterfall that feeds the lagoon is probably about 100 foot long from the top of the rocks down to the pool. To the south of you is the boulders and to the west is stream that leads to a tide pool and to the east is more trees and a pond?

You can see a Cave and a jug here.

I'm weak, tired and especially starving!

>take jug
Okay, I've got it. It's a little wet and slippery.

Maybe some pizza would be awesome?

>clean clothes with jug
You now have a clean clothes.

Maybe some pizza would be awesome?

* * *

>n
You can't go that way.

It feels as though you haven't eaten in weeks. Months, almost.

>e
You head east and stumble upon the many palm trees and run into a…
Wooden Structure
You enter a wooden structure. I dont really know what it is, but it is definitely not trees or anything natural. There seems to be beams, along with what looks like a house foundation. The platform is about 3 feet set up above the ground and there is a brass box in the corner.

You can see some dirty clothes here.

Is there any fruits for me to eat here?

>e
Small forest
You enter a small area full of trees and shurbs. The sun shines through the leaves and trees so perfectly making this whole situation feel so fake. The ground is covered with rocks, moss and dead leaves.

You can see some bananas, a branch and a thin plastic card here.

I really could go for a burger and some ice cream.

>e
You can't go that way.

My tummy is growling so loud.

>n
You can't go that way.

Food would be REALLY great right now.

>n
You can't go that way.

It feels as though you haven't eaten in weeks. Months, almost.

>w
Wooden Structure
You enter a wooden structure. I dont really know what it is, but it is definitely not trees or anything natural. There seems to be beams, along with what looks like a house foundation. The platform is about 3 feet set up above the ground and there is a brass box in the corner.

You can see some dirty clothes here.

I really could go for a burger and some ice cream.

>n
Boulders
An empty place free of many trees. Although there are lots of shurbs surrounding hte big rocky place.

You can see some shrubs and some berries here.

I'm weak, tired and especially starving!

>n
Lagoon
The lagoon has a slight tint of turquoise and is insanely clear. The waterfall that feeds the lagoon is probably about 100 foot long from the top of the rocks down to the pool. To the south of you is the boulders and to the west is stream that leads to a tide pool and to the east is more trees and a pond?

You can see a Cave and a jug here.

Some pizza would be awesome!

>e
North forest
Nothing more ordinary than just another forest here on this abandoned island; tons of trees, moss, shurbs, etc. There's a lot of mysterious noises it freaks me out. It almost sounds like machinery and a bunch of beeping. But I thought there was no one on this island?

You can see Melvin here.

My tummy is growling so loud.

>x melvin
An scragly, old man with glasses. It looks like he is wearing old, dirty, ripped up clothing.

Food would be REALLY great right now.

>talk to melvin
"Hi, there," you say hesitantly.

"**jumps** Um hi…" he replies stunned.

I can't function without my food!

>talk to melvin
"Who are you? Are you stuck on this island too?"

"No definitely not, I came here in search of data."

My tummy is growling so loud.

>talk to melvin
"Oh, do you know how you can get me off this island. I've been stuck for a while, I really need help. I need to get to Malé."

"Ummm I have lost all connections with going back to the city…Ahemm, I'm going to go about my day if thats okay."

Food would be REALLY great right now.

>talk more
I didn't understand that sentence.

>talk to melvin
"Oh, do you know how you can get me off this island. I've been stuck for a while, I really need help. I need to get to Malé."

"Ummm I have lost all connections with going back to the city…Ahemm, I'm going to go about my day if thats okay."

My tummy is growling so loud.

>talk to melvin
"Oh, do you know how you can get me off this island. I've been stuck for a while, I really need help. I need to get to Malé."

"Ummm I have lost all connections with going back to the city…Ahemm, I'm going to go about my day if thats okay."

Is there any fruits for me to eat here?

* * *

>go to wooden structure
You can't see any such thing.

>search wooden structure
You can't see any such thing.

>examine piece of wood
A very large piece of wood that you washed up onto shore on.

>go north
You can't go that way.

>go east
You head east and stumble upon the many palm trees and run into a…怘
Wooden Structure
You enter a wooden structure. I dont really know what it is, but it is definitely not trees or anything natural. There seems to be beams, along with what looks like a house foundation. The platform is about 3 feet set up above the ground and there is a brass box in the corner.

You can see some dirty clothes here.

>examine clothes
A pile of old, dusty, dirty t-shirts and baggy pants.

>use clothes
(first taking the dirty clothes)
I guess I'll carry it…but itꥐƏ's filthy.

I don't want to put on any mysterious clothing. Especially when they are dirty and stinky.

>examine brass box
A 3x3 ft brass box is in the corner of the platform. Like the clothes, it is dusty and dirty.

>open brass box
It seems to be locked.

>use brass box
(first taking the brass box)
That's hardly portable.

>use brass box on platform
I only understood you as far as wanting to use the brass box.

>use brass box on ground
I only understood you as far as wanting to use the brass box.

>move brass box
It is fixed in place.

>stand on brass box
That's not something you can stand on.

>exit wooden structure
I only understood you as far as wanting to exit.

>go west
Beach
You wake up on warm sand in pain. You must've been rolling in the reef when you got tossled around by the waves. Your face, as well as the rest of your body seems to have multiple cuts. In the distance to the east, you can see a wooden structure.

You can see an ocean, some palm trees and a piece of wood here.

>go north
You can't go that way.

>go south
You can't go that way.

>go east
You head east and stumble upon the many palm trees and run into a…
Wooden Structure
You enter a wooden structure. I dont really know what it is, but it is definitely not trees or anything natural. There seems to be beams, along with what looks like a house foundation. The platform is about 3 feet set up above the ground and there is a brass box in the corner.

>e
Small forest
You enter a small area full of trees and shurbs. The sun shines through the leaves and trees so perfectly making this whole situation feel so fake. The ground is covered with rocks, moss and dead leaves.

You can see a branch, some bananas and a thin plastic card here.

>use banana
You can't see any such thing.

>eat banana
You can't see any such thing.

>examine bananas
The yellow or green bananas hang in bunches up in their trees. They look so delicious.

>use branch
(first taking the branch)
I've got it!

You are holding the branch in your right hand like it is a violent obeject.

* * *

>hit bananas
You use the branch and hit the branches that are holding the bananas until a bunch of the bananas fall to the ground.

>eat banana
You can't see any such thing.

>use banana
You can't see any such thing.

>examine banana
You can't see any such thing.

>examine bananas
The yellow or green bananas hang in bunches up in their trees. They look so delicious.

>use bananas
(first taking the bananas)
OK got them.

You can't wear those!

>eat bananas
You eat the bananas in happiness.

I'm really hungry and thirsty, I could really go for some food and something to drink right now.

>examine shurb
You can't see any such thing.

>examine shrub
You can't see any such thing.

>examine shrubs
You can't see any such thing.

>examine plastic card
A thin plastic rectangular card. As your rub it between your hands some of the dirt falls off and you realize that the card is actually an ID card. You can't make out the name of the person due to many scratches, but you see a vague image of a human being and a barcode.

>use plastic card
(first taking the thin plastic card)
You take the card and slip it into your pocket.

You can't wear that!

>use clothes on branch
I only understood you as far as wanting to use the dirty clothes.

>i
You are carrying:
  a thin plastic card
  a branch
  some dirty clothes

>e
You can't go that way.

>w
Wooden Structure
You enter a wooden structure. I dont really know what it is, but it is definitely not trees or anything natural. There seems to be beams, along with what looks like a house foundation. The platform is about 3 feet set up above the ground and there is a brass box in the corner.

>e
Small forest
You enter a small area full of trees and shurbs. The sun shines through the leaves and trees so perfectly making this whole situation feel so fake. The ground is covered with rocks, moss and dead leaves.

>s
You can't go that way.

>n
You can't go that way.

>w
Wooden Structure
You enter a wooden structure. I dont really know what it is, but it is definitely not trees or anything natural. There seems to be beams, along with what looks like a house foundation. The platform is about 3 feet set up above the ground and there is a brass box in the corner.

>n
Boulders
An empty place free of many trees. Although there are lots of shurbs surrounding hte big rocky place.

You can see some shrubs and some berries here.

I haven't eaten anything, please feed me soon.

>eat berries
(first taking the berries)
You eat the berries in happiness.

>e
Open field
You enter a serene open, grassy area. It is like an open field you'd see in movies with couples lying in the grass and picking the dandilions.

>w
Boulders
An empty place free of many trees. Although there are lots of shurbs surrounding hte big rocky place.

You can see some shrubs here.

>n
Lagoon
The lagoon has a slight tint of turquoise and is insanely clear. The waterfall that feeds the lagoon is probably about 200 feet long from the top of the rocks down to the pool.

You can see a Cave here.

>n
You can't go that way.

>o
Sorry, that can't be corrected.

>e
You can't go that way.

>w
You can't go that way.

>s
Boulders
An empty place free of many trees. Although there are lots of shurbs surrounding hte big rocky place.

You can see some shrubs here.

>n
Lagoon
The lagoon has a slight tint of turquoise and is insanely clear. The waterfall that feeds the lagoon is probably about 200 feet long from the top of the rocks down to the pool.

You can see a Cave here.

>examine cave
A big rocky cave under the waterfall.

>n
You can't go that way.

>e
You can't go that way.

>s
Boulders
An empty place free of many trees. Although there are lots of shurbs surrounding hte big rocky place.

You can see some shrubs here.

>w
You can't go that way.

>e
Open field
You enter a serene open, grassy area. It is like an open field you'd see in movies with couples lying in the grass and picking the dandilions.